111111111111111111
100000000100001001
100100100000100001
101111100111111111
101000000000000001
101501040011111111
101001000000000001
101001111111100001
101001300000000001
111111111111111111
