5555555555
0000000000
0000000000
0000000000
2200000003
0000000000
0000000000
0000000000
5555555555
