5555555555
2000000000
2000000000
2000000000
2000000003
2000000000
2000000000
2000000000
5555555555
